22222222222222222222222222222222222222222222222222222222222222222222222222222222
11111111111111111111111111111111111111111111111111111111111111111111111111111111
10001100011000110001100011000110001100011000110001100011000110001100011000110001
22222222222222222222222222222222222222222222222222222222222222222222222222222222
22222222222222222222222222222222222222222222222222222222222222222222222222222222
11111111111111111111111111111111111101111111111111111111111111111111111111111111
10001100011000110001100011000110001103011000110001100011000110001100011000110001
22222222222222222222222222222222222222222222222222222222222222222222222222222222