1111111111111111111111111111111111111111111111111111111111111111111111111111111
1000010001000011111110000000000000011100000000000000000001111111111111000000001
1100021112111121201100000000000000000000001111100000000000000000000000000000001
1500000300000001200000000000111111000000000000000000000000000000000000000000001
1000000000000001000011000000022220000000000000000000000000000000000000000000001
1022000000000000000000000000000000000000000000000000000000000000000000000000001
1022000000000000000000000000000000000000000000000000000000000000000000000000001
1022000000000000000000000000000000000000000000000000000000000000000000000000001
1022000000000000000000000000000000000000000000000000000000000000000000000000001
1022000000000000000000000000000000000000000000000000000000000000000000000000001
1022000000000000000000000000000000000000000000000000000000000000000000000000001
1022000000000000000000000000000000000000000000000000000000000000000000000000001
1022000000000000000000000000000000000000000000000000000000000000000000000000001
1111111111111111111111111111111111111111111111111111111111111111111111111111111