111111111111111
100000030000001
111111111111111
104001040010401
111111111111111